4,4,4,4,4,4,4,4,4,4,4,4,4,4,4,4,4,4,4,100
0,0,0,0,0,0,0,0,0,0,0,0,0,0,0,0,0,0,0,100
0,0,0,0,0,0,0,0,0,0,0,0,0,0,0,0,0,0,0,100
0,0,0,0,0,0,0,0,0,0,0,0,0,0,0,7,0,0,0,100
0,0,0,0,0,0,0,0,0,0,0,0,0,0,0,0,0,0,0,100
0,0,0,0,0,0,0,0,8,0,0,0,0,0,0,0,4,0,0,100
0,0,0,0,0,0,0,0,0,0,0,0,3,3,3,0,0,0,0,100
0,0,0,0,0,0,0,0,0,0,0,0,0,0,0,0,0,0,0,100
0,9,3,3,3,0,0,0,0,0,0,0,0,0,0,0,0,0,0,100
0,0,0,0,0,0,0,0,0,0,0,0,0,0,0,0,0,0,0,100
3,3,3,3,3,3,3,3,3,3,3,3,3,3,3,3,3,3,3,3
